26
26
0 0 0 0 0 0 0 0 0 0 0 0 0 0 0 0 0 0 0 0 0 0 0 0 0 0
0 0 0 0 0 0 0 0 0 0 0 0 0 0 0 0 0 0 0 0 0 0 0 0 0 0
0 0 0 1 1 1 0 1 1 1 0 0 1 1 0 0 1 0 0 1 0 0 2 2 0 0
0 0 0 0 1 0 0 1 0 0 0 1 0 0 1 0 1 0 0 1 0 0 1 1 0 0
0 0 0 0 1 0 0 1 1 1 0 1 0 0 0 0 1 1 1 1 0 0 1 1 0 0
0 0 0 0 1 0 0 1 0 0 0 1 0 0 1 0 1 0 0 1 0 0 2 2 0 0
0 0 0 0 1 0 0 1 1 1 0 0 1 1 0 0 1 0 0 1 0 0 2 2 0 0
0 0 0 0 0 0 0 0 0 0 0 0 0 0 0 0 0 0 0 0 0 0 5 5 0 0
0 0 1 1 1 1 0 0 0 0 0 0 0 0 0 0 0 0 0 0 0 0 5 5 0 0
0 0 3 3 3 3 0 0 0 1 0 0 1 0 2 0 1 1 1 0 0 0 5 5 0 0
0 0 3 3 3 3 0 0 0 1 0 1 0 0 2 0 1 0 0 1 0 0 5 5 0 0
0 0 1 1 1 1 0 0 0 1 1 0 0 0 2 0 1 0 0 1 0 0 5 5 0 0
0 0 0 0 0 0 0 0 0 1 0 1 0 0 2 0 1 0 0 1 0 0 2 2 0 0
0 0 0 0 0 0 0 0 0 1 0 0 1 0 2 0 1 1 1 0 0 0 2 2 0 0
0 0 0 0 0 0 0 0 0 0 0 0 0 0 0 0 0 0 0 0 0 0 0 0 0 0
0 1 1 0 1 1 0 0 0 0 0 0 0 0 0 0 0 0 0 0 0 0 0 0 0 0
1 0 0 1 0 0 1 0 0 0 0 0 0 0 0 0 0 0 0 0 0 0 0 0 5 5
1 0 0 0 0 0 1 0 0 0 1 1 0 1 0 0 0 0 1 0 0 1 1 0 5 5
0 1 0 0 0 1 0 0 0 1 0 0 0 1 0 1 0 1 1 0 1 0 0 1 0 0
0 0 1 0 1 0 0 0 0 1 0 0 0 1 0 0 0 0 1 0 1 0 0 1 0 0
0 0 0 1 0 0 0 0 0 0 1 1 0 1 0 0 0 0 1 0 0 1 1 0 0 0
0 0 0 0 0 0 0 0 0 0 0 0 0 0 0 0 0 0 0 0 0 0 0 0 0 0
0 0 0 0 0 0 0 0 0 0 0 0 0 0 0 0 0 0 0 0 0 0 0 0 0 0
0 0 0 0 0 0 0 0 0 0 0 -1 -1 -1 -1 0 0 0 0 0 0 0 0 0 0 0
0 0 0 0 0 0 0 0 0 0 0 -1 6 7 -1 0 0 0 0 0 0 0 0 0 0 0
0 0 0 0 0 0 0 0 0 0 0 -1 8 9 -1 0 0 0 0 0 0 0 0 0 0 0